#####################
#.............*.....#
#.#################.#
#.#################.#
#.#################.#
#.#################.#
#.#################.#
#.#################.#
#.#################.#
#.#################.#
#.#################.#
#.#################.#
#.#################.#
#.########.########.#
#.########.########.#
#.########.########.#
#.########.########.#
#..................N#
#####################
